Абрикосовая	ул.	Абрыкосавая	Советский			
Авакяна	ул.	Авакяна	Октябрьский			
Авангардная	ул.	Авангардная	Партизанский			
Авангардный	пер.	Авангардны	Партизанский			
Авиации	ул.					
Авиационный	пер.	Авіацыйны				
Авроровская	ул.	Аўрораўская				
Автодоровская	ул.	Аўтадораўская	Московский			
Автодоровский	пер.	Аўтадораўскі	Московский			
Автозаводская	ул.	Аўтазаводская	Заводской			
Автозаводской	пер.	Аўтазавадскі	Заводской			
Автомобилистов	ул.	Аўтамабілістаў	Центральный			
Агатовый	пер.	Агатавы	Центральный			
Азгура	ул.	Азгура	Партизанский			
Азизова	ул.	Азізава	Центральный			
Азовская	ул.	Азоўская	Московский			
Айвазовского	ул.	Айвазоўскага	Заводской			
Айвазовского	пер.	Айвазоўскага	Заводской			
Академическая	ул.	Акадэмічная	Первомайский			
Алибегова	ул.	Алібегава	Московский			
Аллейная	ул.	Алейная	Первомайский			
Алтайская	ул.	Алтайская				
Алтайский	пер.	Алтайскі				
Амбулаторная	ул.	Амбулаторная				
Амбулаторный	пер.	Амбулаторны				
Амураторская	ул.	Амуратарская				
Амурская	ул.	Амурская				
Амурский	пер.	Амурскі				
Ангарская	ул.	Ангарская				
Ангарская 2-я	ул.					
Ангарский	пер.	Ангарскі				
Андреевская	ул.	Андрэеўская				
Аннаева	ул.					
Аннаева	пер.					
Антоновская	ул.	Антонаўская				
Аполинарьевская	ул.	Апалінар'еўская	Советский			
Аранская	ул.	Аранская				
Аранский	пер.					
Арктическая 1-я	ул.					
Арктическая 2-я	ул.					
Артема	ул.	Арцёма				
Артема 1-й	пер.					
Артема 1-й	проезд					
Артема 4-й	проезд					
Артиллеристов	ул.	Артылерыстаў	Октябрьский			
Асаналиева	ул.	Асаналіева	Октябрьский			
Асаналиева	пер.	Асаналіева	Октябрьский			
Аэродромная	ул.	Аэрадромная	Октябрьский			
Аэродромный	пер.	Аэрадромны	Октябрьский			
Аэрофлотская	ул.	Аэрафлотская	Октябрьский			
Аэрофлотский 1-й	пер.	Аэрафлотскі 1-шы				
Бабушкина	ул.	Бабушкіна				
Багратиона	ул.					
Багратиона 1-й	пер.					
Багратиона 2-й	пер.					
Багряная	ул.					
Багряный	пер.					
Базисная 1-я	ул.					
Базисная 2-я	ул.					
Базисный	пер.					
Байкальская	ул.					
Бакинская	ул.					
Балтийская	ул.					
Барановщина	ул.					
Барановщина 1-й	пер.					
Басиаловская	ул.					
Басиаловский 1-й	пер.					
Басиаловский 2-й	пер.					
Алеся Бачило	ул.					
Бангалор	пл.	Бангалор			
Беды	ул.	Бяды				
Белинского	ул.					
Бельского	ул.					
Беломорская	ул.					
Беломорский	пер.					
Белорусская	ул.	Беларуская				
Белорусский 1-й	пер.					
Белорусский 2-й	пер.					
Белорусский 4-й	пер.					
Березинская	ул.	Бярэзінская				
Берестянская	ул.					
Берсона	ул.					
Берсона	пер.					
Бетонный	проезд					
Бехтерева	ул.					
Берута	ул.					
Белецкого	ул.					
Бехтерева	пер.					
Библиотечная	ул.					
Бирюзова	ул.					
Бобруйская	ул.					
Богдана Хмельницкого	ул.		Советский			
Богдановича	пер.	Багдановіча	Советский			
Богдановича	ул.	Багдановіча	Советский			
Болотникова	ул.					
Болотникова	пер.					
Больничный	пер.					
Бородинская	ул.					
Ботаническая	ул.	Батанічная				
Болотная	ул.					
Болотный	пер.					
Боровая	ул.					
Брагинская	ул.					
Брагинский 1-й	пер.					
Брагинский 2-й	пер.					
Братский	пер.					
Брестская	ул.	Брэстская				
Брестский 1-й	пер.					
Брестский 2-й	пер.					
Брестский 3-й	пер.					
Брестский 4-й	пер.					
Брестский 5-й	пер.					
Брилевская	ул.					
Брилевский 1-й	пер.					
Петруся Бровки	ул.	Пятруся Броўкі				
Броневой	пер.					
Брилевский тупик					
Брест-Литовская	ул.					
Буденного	ул.					
Бумажкова	ул.					
Бумажкова	пер.					
Бумажкова	проезд					
Бурдейного	ул.					
Буйло	ул.					
Быховская	ул.	Быхаўская	Октябрьский			
Ванеева площадь		Ванеева			
Змитрока Бядули	ул.	Змітрака Бядулі				
Вавилова	ул.					
Вавилова	пер.					
Ванеева	ул.					
Варвашени	ул.					
Васнецова	ул.					
Васнецова 1-й	пер.					
Васнецова 2-й	пер.					
Ватутина	ул.					
Ватутина	проезд					
Ваупшасова	ул.					
Васильковая	ул.					
Велозаводская	ул.					
Великоморская	ул.					
Великоморский	пер.					
Велосипедный	пер.					
Велосипедный 2-й	пер.					
Верещагина	ул.					
Верхняя	ул.					
Верхний	пер.					
Веснинка	ул.					
Веснинка	пер.					
Веснинка	проезд					
Веснина	проезд					
Весенняя	ул.					
Татарская	ул.					
Вильямса	ул.					
Вильямса 1-й	пер.					
Вирская	ул.					
Витебская	ул.					
Водозаборная	ул.					
Вишневый	пер.					
Водопроводный	пер.					
Войсковый	пер.					
Вокзальная	ул.					
Вокзальный 1-й	пер.					
Волгоградская	ул.					
Волгодонская	ул.					
Волжская	ул.					
Волжский	проезд					
Володарского	ул.					
Волочаевская	ул.					
Восточный	пер.					
Вилковщина	ул.					
Волочаевский 3-й	пер.					
Волочаевский	проезд					
Волоха	ул.					
Воронянского	ул.	Варанянскага	Октябрьский		Кузнечная (стар.)	
Воронянского	пер.	Варанянскага	Октябрьский			
Восточная	ул.					
Володько	ул.	Валадзько	Октябрьский			
Встречная	ул.					
Встречный	пер.					
Вузовский	пер.	Вузаўскі завулак				
Вышелесского	ул.					
Германовская 2-я	ул.					
Германовский 2-й	пер.					
Высокая	ул.					
Высокий	пер.					
Вышелесского	пер.	Вышалескага				
Вышелесского	ул.	Вышалескага				
Гагарина	ул.					
Гало	ул.					
Гамарника	ул.					
Гашкевича	ул.					
Гастелло	ул.					
Гая	ул.					
Гвардейская	ул.					
Гвардейский	пер.					
Герасименко	ул.	Герасіменка	Заводской			
Германовский	пер.					
Герцена	ул.					
Геологическая	ул.					
Геологический	пер.					
Героев 120 дивизии	ул.					
Гикало	ул.	Гікала				
Гинтовта	ул.					
Глаголева	ул.					
Глаголева 2-й	пер.					
Глаголева 3-й	пер.					
Петра Глебки	ул.					
Глинище	проезд					
Гоголевская	ул.					
Голодеда	ул.					
Голодеда	проезд					
Голубева	ул.					
Голубка	ул.	Уладзіслава Галубка				
Гомельский	пер.					
Горный	пер.					
Богдановича	ул.					
Горовца	ул.					
Городецкая	ул.					
Горная	ул.					
Горбатова	ул.					
Горецкого	ул.					
Гребельки	ул.					
Грекова	ул.					
Грекова 1-й	пер.					
Грекова 2-й	пер.					
Грибоедова	ул.					
Грибной	пер.					
Грицевца	ул.					
Гродненская	ул.					
Громова	ул.					
Грушевская	ул.					
Грушевский	пер.					
Гурского	ул.					
Гусовского	ул.					
Гуртьева	ул.		Первомайский			
Дальний	пер.					
Даумана	ул.					
Дачный	пер.					
Дачная	ул.					
Двинская	ул.					
Дворищи	ул.					
Дежнева	ул.					
Декабристов	ул.					
Денисовская	ул.					
Денисовский	пер.					
Дзержинского просп.	просп.	Дзяржынскага	Московский		
Деповский	пер.					
Детский 1-й	пер.					
Детский 2-й	пер.					
Детский 3-й	пер.					
Детдомовская	ул.					
Димитрова	пер.					
Димитрова	ул.					
Днепровская	ул.					
Днепровский	пер.					
Днепровский	проезд					
Добромысленский	пер.					
Доватора	ул.	Даватара				
Докучаева	ул.					
Долгиновский 2-й	пер.					
Долгиновский 3-й	пер.					
Долгиновский 4-й	пер.					
Долгиновский	проезд					
Домашевская	ул.					
Домашевский 4-й	пер.					
Домейко	ул.					
Дорошевича	ул.	Дарашэвіча				
Достоевского	ул.					
Достоевского	пер.					
Домашевский	пер.					
Долгиновский тракт					
Долгобродская	ул.					
Дружная	ул.	Дружная				
Дражня	ул.					
Дражненский 1-й	пер.					
Дражненский 2-й	пер.					
Дрозда	ул.					
Дружба	ул.					
Дубравинская	ул.					
Дубравинский	пер.					
Дунина-Марцинкевича	ул.					
Енисейская	ул.					
Енисейский 1-й	пер.					
Енисейский 2-й	пер.					
Енисейский	проезд					
Есенина	ул.	Ясеніна				
Жилуновича	ул.					
Железнодорожная	ул.					
Железнодорожный 1-й	пер.					
Железнодорожный 2-й	пер.					
Железнодорожный 3-й	пер.					
Железнодорожный 4-й	пер.					
Железнодорожный 5-й	пер.					
Железнодорожный 6-й	пер.					
Железнодорожный 7-й	пер.					
Железнодорожный 8-й	пер.					
Жлобинская	ул.					
Купревича	ул.					
Жудро	ул.					
Жукова просп.	просп.	Жукава			
Жуковского	ул.	Жукоўскага	Октябрьский			
Жуковского 1-й	пер.	Жукоўскага 1-ы				
Жуковского 2-й	пер.	Жукоўскага 2-i				
Заводская	ул.					
Загородный 1-й	пер.					
Загородный 2-й	пер.					
Загородный 3-й	пер.					
Загородный 4-й	пер.					
Заливная	ул.					
Замковая	ул.					
Западная	ул.					
Запорожская	ул.					
Запорожский 1-й	пер.					
Заречная	ул.					
Заречный 1-й	пер.					
Заречный 2-й	пер.					
Заречный 3-й	пер.					
Заречный тупик					
Запорожский 3-й	пер.					
Заслонова	ул.					
Захарова	ул.	Захарава				
Заславская	ул.					
Золотая Горка	ул.	Залатая горка				
Зеленая	ул.		Первомайский			
Зеленый	пер.					
Землемерная 1-я	ул.					
Землемерная 2-я	ул.					
Землемерный	пер.					
Земледельческая	ул.		Центральный			
Земледельческий 1-й	пер.					
Земледельческий 3-й	пер.					
Зенитный	пер.					
Затишье	ул.					
Зимняя	ул.					
Зимний 1-й	пер.					
Зимний 2-й	пер.					
Зубачева	ул.					
Зубачева 1-й	пер.					
Зубачева 2-й	пер.					
Зубачева 3-й	пер.					
Игуменский тракт		Ігуменскі тракт			
Иерусалимская	ул.					
Ивановская	ул.					
Известия газеты просп					
Извозная	ул.					
Извозный 1-й	пер.					
Извозный 2-й	пер.					
Извозный 3-й	пер.					
Измайловская	ул.					
Измайловский 1-й	пер.					
Измайловский 2-й	пер.					
Измайловский 3-й	пер.					
Измайловский 4-й	пер.					
Измайловский	проезд					
Илимская	ул.	Ілімская	Заводской			
Ильменская	ул.					
Индустриальная	ул.					
Инженерная	ул.					
Инструментальный	пер.					
Интернациональная	ул.					
Иркутская	ул.					
Иркутский	пер.					
Искалиева	ул.					
Кабушкина	ул.					
Казарменный	пер.					
Казея	ул.					
Калинина	пл.	Калініна			
Калинина	ул.	Калініна				
Калинина	пер.					
Калининградский	пер.					
Калиновского	ул.					
Кальварийский	проезд					
Казинца площадь					
Канатный	пер.					
Карастояновой	ул.					
Карбышева	ул.	Карбышава				
Карпова	ул.					
Каховская	ул.					
Каховский	пер.					
Кедышко	ул.					
Кирилла и Мефодия	ул.					
Киевская	ул.					
Кижеватова	ул.					
Кирова	ул.					
Киселева	ул.	Кісялёва				
Клецкая	ул.					
Клецкий	проезд					
Клубный	проезд					
Клумова	ул.					
Клумова	пер.					
Ключевая	ул.					
Кнорина	ул.					
Коммунальная набережная					
Ковалева	ул.					
Ковалевской	ул.					
Ковалевской	пер.					
Колесникова	ул.					
Колхозная	ул.					
Коллекторная	ул.					
Коллективный	пер.					
Коллективный	проезд					
Заборского	ул.					
Дроздовича	ул.					
Коммунистическая	ул.	Камуністычная				
Кооперативный	пер.					
Комсомольская	ул.					
Кобринская	ул.					
Козлова	ул.	Казлова				
Козлова	пер.					
Казинца	ул.					
Кольцова 1-й	пер.					
Кольцова 2-й	пер.					
Кольцова 3-й	пер.					
Кольцова 4-й	пер.					
Кольцова	проезд					
Кольцевая 1-я	ул.					
Кольцевая 2-я	ул.					
Кольцевой 1-й	проезд					
Кольцевой 2-й	проезд					
Коласа	ул.	Якуба Коласа				
Коласа	пер.	Якуба Коласа				
Копыльская	ул.	Капыльская				
Копыльский	проезд	Капыльскі				
Копыльский тупик					
Коржа	ул.					
Корш-Саблина	ул.					
Корженевского	ул.					
Корженевского	пер.					
Корзюки	ул.					
Корицкого	ул.					
Короткий 1-й	пер.					
Короткий 2-й	пер.					
Короткий 3-й	пер.					
Короткевича	ул.	Караткевіча				
Короленко	ул.					
Комаровское кольцо					
Космодемьянской	ул.					
Космонавтов	ул.	Касманаўтаў	Московский			
Котовского	ул.					
Котовского	проезд	Катоўскага				
Кошевого	ул.	Кашавога				
Кольцова	ул.	Кальцова	Советский			
Козыревская	ул.					
Крапивы	ул.	Крапівы				
Кропоткина	ул.	Крапоткіна				
Кропоткина 1-й	пер.					
Кропоткина 2-й	пер.					
Красивая	ул.	Прыгожая				
Красивый	пер.	Прыгожы				
Красная	ул.	Чырвоная				
Красная слобода	ул.	Чырвоная Слабада				
Краснослободская	ул.					
Краснозвездная	ул.	Червоназоркавая				
Краснозвездный	пер.	Червоназоркавый				
Красноармейская	ул.					
Красномысленский	пер.					
Крайняя	ул.					
Крамского	ул.	Крамскога				
Круглый	пер.	Круглы				
Крупской	ул.					
Крупцы	ул.	Крупцы				
Крыловича	ул.	Крыловіча				
Крыловича 1-й	пер.					
Крыловича 2-й	пер.					
Кривая	ул.					
Кубанская	ул.					
Кузнечная	ул.					
Кузнечный	проезд					
Куйбышева	ул.					
Кулешова	ул.	Куляшова				
Кулибина	ул.					
Кульман	ул.	Кульман				
Янки Купалы	ул.	Янкі Купалы				
Куприянова	ул.					
Кутузова	ул.					
Короля	ул.	Караля				
Курчатова	ул.					
Кунцевщина	ул.	Кунцаўшчына				
Курганная	ул.					
Кэчевский	пер.					
Лазарева	ул.					
Лазо	ул.					
Лазо	пер.					
Ландера	ул.					
Логойский тракт		Лагойскі тракт			
Левкова	ул.					
Ленина	ул.	Леніна				
Ленинградская	ул.					
Лермонтова	ул.	Лерманатава				
Лесная	ул.					
Летняя	ул.					
Летний 1-й	пер.					
Летний 2-й	пер.					
Лещинского	ул.					
Либаво-Роменская	ул.					
Линейный	пер.					
Либкнехта	ул.					
Литературная	ул.					
Литературный	пер.					
Лодочная	ул.					
Лодочный	пер.					
Ломоносова	ул.					
Ломоносова	пер.					
Лошица 2-ая	ул.					
Ложинская	ул.					
Лобанка	ул.					
Лошицкий	проезд					
Луговая	ул.	Лугавая				
Луговой	пер.					
Мулявина бульвар		Мулявіна			
Лошицкая	ул.					
Лошицкий	пер.					
Лынькова	ул.					
Лучины	ул.	Янкі Лучыны				
Любимова просп.	просп.		Московский		
Розы Люксембург	ул.					
Розы Люксембург 2-й	пер.					
Любанская	ул.					
Майкова	пер.					
Магистральная	ул.					
Мавра	ул.					
Магнитная	ул.					
Магнитный	пер.					
Магазинная	ул.					
Малая	ул.					
Малый	пер.					
Малый 2-й	пер.					
Малинина	ул.					
Маневича	ул.					
Малявки	ул.					
Марата	ул.	Марата				
Марьевская	ул.					
8-го марта	8-га сакавіка				
Матвеевская	ул.					
Матвеевский	пер.					
Матросова	ул.					
Матусевича	ул.					
Машинистов	ул.					
Маяковского	ул.	Маякоўскага				
Маркса	ул.	Маркса				
Маяковского	пер.					
Машерова просп.	просп.	Праспект Машэрава			
Машинистов	пер.					
Макаенка	ул.	Макаёнка				
Машиностроителей	ул.					
Макаренко	ул.					
Мебельный	пер.					
Медвежино	ул.					
Медвежино	пер.					
Мележа	ул.	Мележа				
Мелиоративная	ул.					
Мелиоративный	пер.					
Мельничный 1-й	пер.					
Мельникайте	ул.					
Менделеева	ул.					
Менделеева 1-й	пер.					
Меньковский тракт					
Металлистов 1-й	пер.					
Металлистов	проезд					
Мержинского	ул.					
Мазурова	ул.	Мазурава				
Минина	ул.					
Минина	пер.					
Мирная	ул.					
Мирошниченко	ул.					
Мичурина	ул.					
Михайлова	ул.					
Михайловский	пер.					
Михалово	ул.					
Михалово 1-й	пер.					
Михалово 2-й	пер.					
Михалово 3-й	пер.					
Михалово 4-й	пер.					
Могилевская	ул.	Магілёўская				
Могилевский	пер.	Магілёўская				
Можайская	ул.					
Можайский 1-й	пер.					
Можайский 2-й	пер.					
Мозырская	ул.	Мазырская				
Мозырский	пер.	Мазырскі				
Мозырский	проезд	Мазырскі				
Молочный	пер.					
Можайский 3-й	пер.					
Мопра	ул.					
Москвина	ул.					
Москвина	пер.					
Московская	ул.					
Музыкальный	пер.					
Мядельская	ул.					
Мясникова	ул.	Мяснікова				
Мясникова	пл.	Мяснікова			
Нагорная	ул.					
Нагорный	пер.					
Надеждинская	ул.					
Наклонная	ул.					
Наклонный 1-й	пер.					
Наклонный 2-й	пер.					
Наполеона Орды	ул.				[1]
Народная	ул.	Народная				
Натуралистов	ул.	Натуралістаў				
Нахимова	ул.					
Невский	пер.					
Неждановой	ул.					
Неждановой	пер.					
Независимости	пл.	Плошча Незалежнасці				
Независимости	просп.	Праспект Незалежнасці			Скорины (стар.)	
Некрасова	ул.					
Некрасова	пер.					
Немига	ул.	Няміга				
Несвижская	ул.					
Нестерова	ул.	Несцерава	Заводской			
Нестерова 1-й	пер.					
Нестерова 2-й	пер.					
Нефтяная	ул.					
Нефтяной	пер.					
Нарочанская	ул.					
Никитина	ул.					
Никитина 1-й	пер.					
Никитина 2-й	пер.					
Никифорова	ул.					
Новаторская	ул.					
Новаторский	пер.					
Новаторский	проезд					
Новая	ул.					
Новгородская	ул.					
Новгородский	пер.					
Нововиленская	ул.					
Нововиленский	пер.					
Набережная	ул.					
Новосельская	ул.					
Новосельский	пер.					
Новоуфимская	ул.					
Новоуфимский	проезд					
Ногина	ул.					
Богушевича площадь					
Обойная	ул.					
Обойный	пер.					
Обувной	пер.					
Обуховская	ул.					
Обуховский 1-й	пер.					
Обуховский 3-й	пер.					
Обуховский 4-й	пер.					
Объединенных наций пл.					
Огарева	ул.					
Одесская	ул.					
Одесский	пер.					
Одинцова	ул.					
Одоевского	ул.					
Одоевского	пер.					
Озерная	ул.					
Озерный	пер.					
Озерцовский тракт					
Окрестина	ул.					
Окрестина 1-й	пер.					
Окружной	проезд					
Октябрьская	пл.	Кастрычніцкая				
Октябрьская	ул.	Кастрычнічкая				
Ольшевского	ул.					
Олешева	ул.					
Ольшевского	пер.					
Омельянюка	ул.					
Кальварийская	ул.					
Оранжерейная	ул.					
Орловский 3-й	пер.					
Орловский 4-й	пер.					
Орловский 5-й	пер.					
Орловский 6-й	пер.					
Орловский 7-й	пер.					
Орловский 8-й	пер.					
Орджоникидзе	ул.					
Оршанская	ул.					
Оршанский	проезд					
Орловская	ул.					
Освобождения	ул.					
Осенняя	ул.					
Осенний 1-й	пер.					
Осенний 2-й	пер.					
Осипенко	ул.					
Осиповичская	ул.					
Раковская	ул.					
Острошицкая	ул.					
Основателей	ул.					
Охотская	ул.					
Охотский	пер.					
Охотский	проезд					
Павлова	ул.					
Павлова	пер.					
Панфилова	ул.					
Папанина	ул.					
Парашютистов	ул.					
Парижской коммуны площадь					
Парковая	ул.					
Парниковый 2-й	пер.					
Парниковая	ул.					
Парниковый	проезд					
Парниковый 3-й	пер.					
Паровозный	пер.					
Партизанский просп.	просп.	Партызанскі			
Партизанская	ул.	Партызанская				
Пархоменко	ул.					
Пашкевич	ул.					
Пензенская	ул.					
Первомайская	ул.	Першамайская				
Передовая	ул.					
Передовой	пер.					
Перекопская	ул.					
Переходная	ул.					
Переходный 1-й	пер.					
Переходный 2-й	пер.					
Пермская	ул.					
Пермский	пер.					
Песочная 2-я	ул.					
Петровщина	ул.					
Петровщина	пер.					
Пилотская	ул.					
Пинская	ул.					
Пионерская	ул.					
Пирогова	ул.					
Пирогова 1-й	пер.					
Пирогова 2-й	пер.					
Планерная	ул.					
Платонова	ул.					
Плеханова	ул.					
Подлесная	ул.					
Подгорная	ул.					
Победы	пл.	Плошча Перамогі				
50 лет Победы	ул.	50 гадоў Перамогі	Первомайский			
Победителей	просп.	Пераможцаў			Машерова (устар.)	
Подольская	ул.					
Подольский 1-й	пер.					
Подольский 2-й	пер.					
Подольский 3-й	пер.					
Подольский 4-й	пер.					
Попова	ул.					
Кулешова 1-й	пер.					
Кулешова 2-й	пер.					
Подшипниковый	проезд					
Пономарева	ул.	Панамарова	Первомайский			
Пожарная	ул.					
Пожарского	ул.					
Полевая	ул.					
Полевой	пер.					
Полесская	ул.					
Ползунова	пер.					
Полиграфическая	ул.					
Полиграфический 1-й	пер.					
Полиграфический 2-й	пер.					
Полиграфический 3-й	пер.					
Полиграфический 4-й	пер.					
Полоцкий	пер.					
Полтавская	ул.					
Поселковая 1-я	ул.					
Поселковая 2-я	ул.					
Лукьяновича	ул.	Лукьяновіча				
Поселковый	пер.					
Поселковый 2-й	пер.					
Поселковый 3-й	пер.					
Полярная	ул.					
Пономаренко	ул.					
Правда газеты просп.	просп.				
Пржевальского	ул.					
Пржевальского 2-я	ул.					
Привокзальная					
Пригородная	ул.					
Прилукская	ул.					
Привлекательная	ул.					
Прилукский 2-й	пер.					
Притыцкого	ул.					
Прогрессивная	ул.					
Проездной	пер.					
Приозерная	ул.					
Прямая	ул.					
Промышленный	пер.					
Промышленная	ул.					
Псковская	ул.					
Почтовая	ул.					
Прушинских	ул.					
Пугачевская	ул.					
Пулихова	ул.					
Путейская	ул.					
Путейский	пер.					
Путепроводный 1-й	пер.					
Путепроводный 2-й	пер.					
Путепроводный 3-й	пер.					
Путепроводный 4-й	пер.					
Путепроводный 5-й	пер.					
Путепроводный 6-й	пер.					
Путепроводный 7-й	пер.					
Путепроводный 8-й	пер.					
Пуховичская	ул.					
Пушкина просп.	просп.				
Путилова	ул.					
Рабкоровская	ул.					
Рабкоровский	пер.					
Рабочий	пер.					
Радиальная	ул.					
Радиаторная 1-я	ул.					
Радиаторный 1-й	пер.					
Радиаторный 2-й	пер.					
Радиаторный 3-й	пер.					
Радиаторный 4-й	пер.					
Радиаторный 5-й	пер.					
Радиаторная 2-я	ул.					
Радищева	ул.					
Радошковичская	ул.					
Разинская	ул.					
Разинский	пер.					
Рафиева	ул.		Московский			
Райниса	ул.					
Радужная	ул.					
Революционная	ул.					
Репина	ул.					
Романовская Слобода	ул.					
Рижская	ул.					
Рижский 1-й	пер.					
Рижский 2-й	пер.					
Родниковая	ул.					
Ротмистрова	ул.					
Рогачевский	пер.					
Рогачевский	проезд					
Рокоссовского просп.	просп.				
Роменская	ул.					
Русановича	ул.					
Руссиянова	ул.					
Румянцева	ул.					
Рыбалко	ул.					
Рылеева	ул.					
Рущица	ул.					
Садовая	ул.					
Самарский	пер.					
Саперов	ул.					
Свердлова	ул.					
Светлая	ул.					
Свирский 1-й	пер.					
Свирский 2-й	пер.					
Свирский 3-й	пер.					
Свирский 4-й	пер.					
Свислочская	ул.				Располагалась вдоль Чижовского водохранилища. Новая Свислочская улица (проектируемое название - Магистральная) пройдет вдоль одноименной городской реки на участке от улицы Машиностроителей до Инженерной.[1]	
Свободы	ул.					
Свободы площадь	пл.	Плошча Свабоды			
Севастопольская	ул.	Севастопальская	Первомайский			
Севастопольский	пер.					
Северный	пер.					
Седова	ул.					
Седых	ул.					
Селицкого	ул.					
Семашко	ул.					
Семенова	ул.					
Сенницкая	ул.					
Сенницкий	проезд					
3 сентября	ул.					
Серафимовича	ул.					
Сердича	ул.					
Серебрянская	ул.					
Серебрянский	пер.					
Серова	ул.					
Сеченова	ул.					
Силикатный 1-й	пер.					
Силикатный 2-й	пер.					
Сиреневая	ул.					
Скорины	ул.	Скарыны				
Скорины 1-й	пер.					
Скрипникова	ул.					
Скрыганова	ул.					
Славинского	ул.					
Славный	пер.					
Славянская	ул.					
Большая Слепня	ул.					
Слепнянский 2-й	пер.					
Слепнянский 4-й	пер.					
Слесарная	ул.					
Слободской	пер.					
Слонимская	ул.	Слонімская				
Слонимский 1-й	пер.	Слонімскі				
Слуцкой	ул.					
Слободская	ул.		Московский			
Слободской	проезд		Московский			
Смирнова	ул.					
Смоленская	ул.					
Смолячкова	ул.					
Сморговский тракт					
Сморговский 1-й	пер.					
Сморговский 2-й	пер.					
Сморговский 3-й	пер.					
Сморговский 4-й	пер.					
Сморговский 5-й	пер.					
Сморговский	проезд					
Снежный	пер.					
Собинова	ул.					
Собинова 2-й	пер.					
Советская	ул.	Савецкая				
Соколянский	пер.					
Сосновая	ул.					
Солнечная	ул.					
Собинова	пер.					
Соломенная	ул.					
Солтыса	ул.					
Солтыса	пер.					
Социалистическая	ул.					
Стариновская	ул.					
Стадионная	ул.					
Степянская	ул.					
Степянский	пер.					
Станиславского	ул.					
Старобинская	ул.					
Староборисовский тракт					
Старовиленская	ул.	Старавіленская				
Старовиленский тракт		Старавіленскі тракт			
Сторожевская	ул.	Старажэўская				
Стасова	ул.					
Стасова 1-й	пер.					
Стасова 2-й	пер.					
Стасова 3-й	пер.					
Стахановская	ул.					
Стахановский	пер.					
Стебенева	ул.					
Стебенева	пер.					
Стекольный	пер.					
Степной	пер.					
Столбцовская	ул.					
Столетова	ул.					
Столетова	пер.					
Столетова	проезд					
Стрелковая	ул.					
Строителей	ул.					
Студенческая	ул.					
Студенческий	пер.					
Малое Стиклево	ул.					
Степная	ул.					
Суворова	ул.					
Судмалиса	ул.					
Суражская	ул.					
Сурганова	ул.		Советский Первомайский			
Сурикова	ул.					
Сурикова	пер.					
Сурикова	проезд					
Сухая	ул.					
Чайлытко	ул.					
Сухаревская	ул.					
Тобольский	пер.					
Таежная	ул.					
Талаша	ул.	Талаша				
Талаша	пер.	Талаша				
Таллиннская	ул.					
Таллиннский	пер.					
Танка	ул.	Максіма Танка				
Тарашкевича	ул.					
Тарханова	ул.					
Ташкентская	ул.					
Ташкентский	проезд					
Тбилисская	ул.					
Твердый 1-й	пер.					
Телеграфный	пер.					
Тенистая	ул.					
Тепличная	ул.					
Тепличный	пер.					
Тикоцкого	ул.					
Типографский	проезд					
Тимирязева	пер.					
Тимирязева	ул.					
Тимошенко	ул.					
Тиражная	ул.					
Тиражный 1-й	пер.					
Тиражный 2-й	пер.					
Тиражный	проезд					
Тихая	ул.					
Тихий	пер.					
Товарищеский	пер.					
Толбухина	ул.					
Толстого	ул.					
Толстого	пер.					
Толстого	проезд					
Томская	ул.					
Томский	пер.					
Топографическая	ул.					
Топографический 1-й	пер.					
Топографический 2-й	пер.					
Торговая	ул.					
Торфяной	пер.					
Азгура	ул.					
Тракторостроителей бульвар					
Транспортный	пер.					
Тростенецкая	ул.					
Трубный 1-й	пер.					
Трубный 2-й	пер.					
Трубный 3-й	пер.					
Трудовая	ул.					
Тростенец малый	ул.					
Тростенец малый	пер.					
Трубный	пер.					
Труса	ул.					
Тульская	ул.					
Тульский 1-й	пер.					
Тульский 2-й	пер.					
Тургенева	ул.					
Тухачевского	ул.					
Тучинский	пер.					
Тупиковая	ул.					
Тяпинского	ул.					
Уборевича	ул.					
Уборевича	проезд					
Украинская	ул.					
Украинки	ул.					
Ульяновская	ул.					
Уманская	ул.					
Уманская 1-я	ул.					
Уральская	ул.					
Уральский	пер.					
Городской Вал	ул.					
Урожайная	ул.					
Уручская	ул.					
Уручье	ул.					
Уфимская	ул.					
Ученический	пер.					
Ушакова	ул.					
Ушакова	пер.					
Уютная	ул.					
Фабрициуса	ул.					
Фабрициуса	пер.					
Фабричная	ул.					
Фабричный 1-й	пер.					
Фабричный 2-й	пер.					
Фанипольская	ул.					
Фанипольский	пер.					
Федорова	ул.					
Федотова	ул.					
Федотова	пер.					
Физкультурная	ул.					
Физкультурный	пер.					
Физкультурный 2-й	пер.					
Филатова	ул.					
Филимонова	ул.					
Фогеля	ул.	Фогеля				
Фомина	ул.					
Фомина 1-й	пер.					
Фомина 2-й	пер.					
Фроликова	ул.					
Фруктовый	пер.					
Фрунзе	ул.					
Фучика	ул.		Заводской			
Хабаровская	ул.					
Халтурина	ул.					
Халтурина 1-й	пер.					
Халтурина 2-й	пер.					
Харьковская	ул.					
Харьковский 3-й	пер.					
Хмелевского	ул.					
Хмельницкого	ул.					
Холмогорская	ул.					
Холмогорский 1-й	пер.					
Холмогорский 2-й	пер.					
Холмогорский 3-й	пер.					
Холмогорский 4-й	пер.					
Хоружей	ул.					
Центральная	ул.					
Цеткин	ул.					
Циолковского	ул.					
Циолковского 2-й	пер.					
Цнянская	ул.	Цнянская				
Чайкиной	ул.					
Чайковского	ул.					
Чайковского	пер.					
Чайковского	проезд					
Чапаева	ул.					
Чарота	ул.					
Чеботарева	ул.					
Чекалина	ул.					
Чекалина	проезд					
Челюскинцев	ул.	Чалюскінцаў				
Челюскинцев 2-й	пер.	Чалюскінцаў				
Червякова	ул.	Чарвякова				
Червякова	пер.	Чарвякова				
Черниговская	ул.					
Черниговский 1-й	пер.					
Чернышевского	ул.	Чарнышэўскага	Первомайский			
Чернышевского 1-й	пер.					
Черняховского	ул.					
Чехова	ул.					
Чигладзе	ул.					
Чижевская	ул.					
Чичерина	ул.					
Чижевских	ул.					
Чижевских	пер.					
Чижевских	проезд					
Чкалова	ул.	Чкалава	Октябрьский			
Чорного	ул.					
Чорного	пер.					
Шабаны	ул.	Шабаны				
Шабловского	ул.					
Шаранговича	ул.					
Шатько	ул.					
Шафарнянская	ул.					
Шевченко бульвар					
Шейпичи	ул.					
2-я 6-я линия	ул.					
Шемеша	ул.					
Ширмы	ул.	Рыгора Шырмы				
Широкая	ул.					
Шишкина	ул.					
Шпилевского	ул.					
Школьная	ул.					
Школьный	пер.					
Шорная	ул.					
Шоссейная	ул.					
Шугаева	ул.					
Щедрина	ул.					
Щедрина 1-й	пер.					
Щедрина 2-й	пер.					
Щедрина 3-й	пер.					
Щепкина	ул.					
Щербакова	ул.					
Щербакова	пер.					
Щорса	ул.	Шчорса				
Щорса 2-я	ул.					
Щорса 3-я	ул.					
Щорса 4-я	ул.					
Щорса 5-я	ул.					
Щетовка	ул.					
Экскаваторная	ул.					
Экскаваторный	пер.					
Энгельса	ул.					
Энергетический	проезд					
Юбилейная	ул.					
Юбилейный	пер.					
Юбилейная площадь					
Южная	ул.					
Южный	пер.					
Южный 1-й	пер.					
Юношеская	ул.					
Юношеский 1-й	пер.					
Юношеский 2-й	пер.					
Ярковская	ул.					
Ясная	ул.					
Яблоневая	ул.					
Якуба Коласа	пл.	Якуба Коласа				
Якубова	ул.					
Якубовского	ул.					
Янковского	ул.					
Игнатенко	ул.					
Кольцевая					
Сырокомли	ул.					
Беляева	ул.					
Рогачевская	ул.					
Водолажского	ул.					
Кабушкина	пер.					
Связистов	ул.					
Корвата	ул.					
Парашютная	ул.					
Панченко	ул.					
Краснодонская	ул.					
Масюковщина	проезд					
Районная 1-я магистраль					
Мачульского	ул.					
Ельницкая	ул.					
Профсоюзная	ул.					
Профсоюзный	пер.					
Профсоюзный	проезд					
Пашковичи пос.					
Климовичи пос.					
Серебрянская малая	ул.					
Слепнянский 5-й	пер.					
Выготского	ул.					
Скалинская	ул.					
Ярошевичская	ул.					
Ярошевичский	пер.					
Олимпийский просп.	просп.				
Монтажников	ул.					
Монтажников 1-й пер					
Монтажников 2-й пер					
Монтажников 3-й пер					
Монтажников 4-й пер					
Авиации	ул.					
Барамзиной	ул.					
Березогорская	ул.					
Взлетная	ул.					
Волмянская	ул.					
Звездная	ул.					
Киреева	ул.					
Ромашкина	ул.					
Рябиновая	ул.					
Туполева	ул.					
Красина	ул.					
Павловского	ул.					
Новинковская	ул.					
Каганца	ул.					
Жасминовая	ул.					
Буйницкого	ул.					
Буйницкого	пер.					
Ваньковича	ул.					
Брикета	ул.					
Жебрака	ул.					
Жебрака	пер.					
Ивенецкая	ул.					
Воложинская	ул.					
Масюковщина	ул.					
Масюковщина	пер.					
Ржавецкая	ул.					
Баторинская	ул.					
Запрудная	ул.					
Придорожная	ул.					
Зацень	ул.					
Ермака	ул.					
Ермака	пер.					
Рябинницкая	ул.					
Магулянская	ул.					
Миколаевская	ул.					
Заречанская	ул.					
Заречанский	пер.					
Приветливая	ул.					
Стефановская	ул.					
Огородницкая	ул.					
Ошмянская	ул.					
Ошмянский	пер.					
Гольшанская	ул.					
Гольшанский 1-й	пер.					
Бровикова	ул.					
Микулича	ул.					
Иодковская	ул.					
Иодковский	пер.					
Зеленолужская					
Хмаринская	ул.					
Папернянская	ул.					
Папернянский	пер.					
Липовая	ул.					
Сосновый бор	ул.					
Дубовлянский	пер.					
Виноградная	ул.					
Малофеевская	ул.					
Фольварковая	ул.					
Фольварковый	пер.					
Вересковая	ул.					
Усадебная	ул.					
Усадебный	пер.					
Докшицкая	ул.					
Бельчицкая	ул.					
Кривичская	ул.					
Кривичский 2-й	пер.					
Глубокская	ул.					
Лепельская	ул.					
Монюшко	ул.					
Марусинская	ул.					
Браславская	ул.					
Ушачская	ул.					
Марусинский	пер.					
Марусинский 1-й	пер.					
Марусинский 2-й	пер.					
Янтарная	ул.					
Ольховая	ул.					
Ириновская	ул.					
Ириновский	пер.					
Александровская	ул.					
Вязынская	ул.					
Вязынский 1-й	пер.					
Вязынский 2-й	пер.					
Радошковичская	ул.					
Радошковичский	пер.					
Гольшанский 2-й	пер.					
Кривичский 2-й	пер.					
Шумилинская	ул.					
Раубичский	пер.					
Баторинский	пер.					
Вилейский	пер.					
Будславская	ул.					
Будславский	пер.					
Бегомльская	ул.					
Россонская	ул.					
Боровецкий	пер.					
Раубичская	ул.					
Поставская	ул.					
Воропаевская	ул.					
Друйская	ул.					
Освейская	ул.					
Дисенская	ул.					
Серебряное кольцо	ул.					
Золотая	ул.					
Озерный	пер.					
Речная	ул.					
Изумрудный	пер.					
Золотой	пер.					
Могилевский	пер.					
Мопра	ул.					
Павлюка Труса	ул.					
Новоуфимский	проезд					
Парниковый	проезд					
Парашютистов	ул.					
Циолковского	ул.					
Толстого	проезд					
Типографский	проезд					
Тарашкевича	ул.					
Тбилисская	ул.					
Слепнянский 4-й	пер.					
Слонимский 1-й	пер.					
Труса	ул.					
Станислава Монюшко	ул.					
Фруктовый	пер.					
Язепа Дроздовича	ул.	Язэпа Драздовіча				
Степная	ул.					
Циолковского 2-й	пер.					
Уручье	ул.	Уручча